##############
#    #O  X #O#
# X   X  #   #
#  # #O#O  # #
#   X   #X## #
##  # # #  X #
# O#   ##O# P#
##############