##################
#           P    #
#   X            #
####             #
#OO              #
######           #
#       X        #
#                #
#                #
#                #
##################